WWWWWWWWWWWWWWWWWW
W..................W
W....P.....O...C...W
W..................W
W...C........O.....W
W...................W
W.....O...........  W
W.........C......G..W
WWWWWWWWWWWWWWWWWW]