
WWWWWW
W...P..WWWW
WWW..O.....WWWW
W.....WWWWWWWWWW
W...c...........W
WWWWW...O.....O..WW
W..........C.......WW
W.....C........... WW
W..G................WW
WWWWWWWWWWWWWWWWWWW