WWWWWWWWW
W.........WWW
W....P......WWW
W....WWW..........W
W...............WWWWWWWWW
W...C...........W
W............G.W
W...O..........W
W..........C....W
WWWWWWWWWWWWWWWW